1111111111
100C0001E1
10P1111001
100001C001
1111111111