1111111111
100C0001E1
10P1010001
10C00000C0
1111111111