1111111111111111111
1P001C00000000000C1
1010101111111111101
1010001000001000001
1C10111011101011101
1000100010000010001
10111011101110101C1
10000000000000000E1
1111111111111111111