1111111111
1P00C000C1
1111011101
1C00000101
10111010E1
1C00C00001
1111111111