111111111
1P0C00001
111110101
100000101
101111101
1C0000E01
111111111